O █████████████████████████████
  █   █   █ █ █               █
█ █ ███ ███ █ █████ █ █ █ █ ███
█     █   █   █     █ █ █ █ █ █
█████ █ ███ █ █ █ ███████ ███ █
█   █ █     █ █ █   █   █     █
███ █ █ ███ █ █ ███ █ ███ ███ █
█         █ █     █ █   █ █   █
█ ███████ ███ ███████ ███ █ ███
█ █ █ █ █   █   █       █ █ █ █
███ █ █ █ ███ ███ █ ███ ███ █ █
█           █   █ █ █ █ █     █
███ ███ █████ ███ █ █ ███ █ ███
█   █       █     █ █ █   █   █
█ ███ ███████ █████ █ ███████ █
█ █         █ █         █     █
███ █████ ███ ███ █ █ ███████ █
█   █       █   █ █ █       █ █
█ ███████ ███████ ███ █ █ ███ █
█     █ █   █       █ █ █ █ █ █
█████ █ █████ ███████ ███ █ █ █
█     █ █ █ █   █ █     █ █   █
█ █████ █ █ ███ █ █ █ ███ █████
█   █     █ █   █   █   █   █ █
█ ███ █████ ███ █████ ███ ███ █
█   █     █ █   █ █     █     █
███ ███ ███ ███ █ ███ ███████ █
█     █       █ █ █     █ █   █
█ █ █ ███████ █ █ ███ █ █ █ ███
█ █ █   █       █     █   █    
█████████████████████████████ X